111111111
100C00001
1P0000001
100C0CE01
111111111