11111111111111111111111
10000P00000000001000001
100000000000000010E0001
1000C000000C00000000001
1000C000000C00000000001
1000C000000C00000000001
1000C000000C00000000001
1000C000000C00000000001
1000C000000C00000000001
1000C000000C00000000001
11111111111111111111111