111111111111111111111111111111111111111111111111111111111111111111111111111111111111111111111111111111
1000000000000000100000000000C0E0011000000000000000100000000000C0E0011000000000000000100000000000C0E001
1000000000000000000000P0000000000000000000000000000000000000000000000000000000000000000000000000000001
111111111111111111111111111111111111111111111111111111111111111111111111111111111111111011111111111111