111111111
100C00001
100000001
100C0CE01
111111111